%%%%%%%%%%%%%%
% .        . %
% ...    ... %
% .        . %
% .   P    . %
%          . %
%          . %
%     .    . %
%  ....    . %
%%%%%%%%%%%%%%
