%%%%%%%%%%%%
%  .       %
%          %
%          %
%          %
%       .. %
%          %
%          %
%.         %
%P         %
%%%%%%%%%%%%
