%%%%%%%%%%
%.%     .%
% % %%%%%%
% %      %
% %%%%%% %
%  %   % %
%  % %   %
%  % %%%%%
%  %    P%
%  %     %
%  %     %
%  %     %
%  %     %
%  %     %
%  %     %
%.       %
%%%%%%%%%%