%%%%%%%%%%
%   .    %
%     P  %
%.     . %
%        %
%        %
%   .    %
%%%%%%%%%%